4 4 4 4 4 4 4 4 4 4 4 4 4 4 4 4 4 4 4 4 4 4 4 4 4 4 4 4 4 4 4 4 4 4 4 4 4 4 4 4 4
4 4 4 4 4 4 4 4 4 4 4 4 4 4 4 4 4 4 4 0 0 0 0 0 0 0 0 0 0 0 0 0 0 0 0 0 4 4 4 4 4
4 4 4 4 0 0 0 0 0 0 0 0 0 0 0 0 4 4 4 4 4 4 4 4 4 4 4 4 4 4 4 4 4 4 4 0 4 4 4 4 4
4 4 4 4 0 4 4 4 4 4 4 4 4 4 4 0 0 0 3 3 3 0 4 4 4 4 4 4 4 4 4 4 4 4 4 0 4 4 4 4 4
4 4 4 4 0 4 4 4 4 4 4 4 4 4 4 4 4 4 2 3 2 4 4 4 4 4 4 4 4 4 4 4 4 4 4 0 4 4 4 4 4
4 4 4 4 0 4 4 4 4 4 4 4 4 4 4 4 4 4 2 3 2 4 4 4 4 4 4 4 4 4 4 4 4 4 4 0 4 4 4 4 4
4 4 4 4 0 4 4 4 4 4 4 4 4 4 4 4 4 4 2 3 2 4 4 4 4 4 4 4 4 4 4 4 4 4 4 0 4 4 4 4 4
4 4 4 4 0 4 4 4 1 1 1 1 1 1 1 1 1 1 1 5 1 1 1 1 1 1 1 1 1 1 1 1 1 4 4 0 4 4 4 4 4
4 4 4 4 0 4 4 4 1 5 5 5 5 5 5 5 5 5 1 5 1 5 5 5 5 5 5 5 5 5 5 5 1 4 4 0 4 4 4 4 4
4 4 4 4 0 4 4 4 1 5 1 1 1 1 1 1 1 5 1 5 1 5 1 1 1 1 1 1 1 1 1 5 1 4 4 0 4 4 4 4 4
4 4 4 4 0 4 4 4 1 5 1 5 5 5 5 5 5 5 1 5 1 5 5 5 5 5 5 5 5 5 1 5 1 4 4 0 4 4 4 4 4
4 4 4 4 0 4 4 4 1 5 1 5 1 1 1 1 1 1 1 5 1 1 1 1 1 1 1 1 1 5 1 5 1 4 4 0 4 4 4 4 4
4 4 4 4 0 4 4 4 1 5 1 5 1 5 5 5 5 5 1 5 1 5 5 5 5 5 5 5 1 5 1 5 1 4 4 0 4 4 4 4 4
4 4 4 4 0 4 4 4 1 5 1 5 1 5 1 5 1 1 1 5 1 5 1 1 1 1 1 5 1 5 1 5 1 4 4 0 4 4 4 4 4
4 4 4 4 0 4 4 4 1 5 1 5 1 5 1 5 1 5 5 5 1 5 5 5 5 5 1 5 1 5 1 5 1 4 4 0 4 4 4 4 4
4 4 4 4 0 4 4 4 1 5 1 5 1 5 1 5 1 5 1 1 1 1 1 1 1 5 1 5 1 5 1 5 1 4 4 0 4 4 4 4 4
4 4 4 4 0 4 4 4 1 5 1 5 1 5 1 5 1 5 1 3 3 3 5 5 1 5 1 5 1 5 1 5 1 4 4 0 4 4 4 4 4
4 4 4 4 0 4 4 4 1 5 1 5 5 5 1 5 5 5 1 2 3 2 1 5 5 5 1 5 5 5 1 5 1 4 4 0 4 4 4 4 4
4 4 4 4 0 4 4 4 1 5 1 1 1 1 1 1 1 1 1 2 2 2 1 1 1 1 1 1 1 1 1 5 1 4 4 0 4 4 4 4 4
4 4 4 4 0 4 4 4 1 5 1 5 5 5 1 5 5 5 1 1 1 1 1 5 5 5 1 5 5 5 1 5 1 4 4 0 4 4 4 4 4
4 4 4 4 0 4 4 4 1 5 1 5 1 5 1 5 1 5 5 5 5 5 5 5 1 5 1 5 1 5 1 5 1 4 4 0 4 4 4 4 4
4 4 4 4 0 4 4 4 1 5 1 5 1 5 1 5 1 1 1 1 1 1 1 1 1 5 1 5 1 5 1 5 1 4 4 0 4 4 4 4 4
4 4 4 4 0 4 4 4 1 5 1 5 1 5 1 5 5 5 5 5 1 5 5 5 5 5 1 5 1 5 1 5 1 4 4 0 4 4 4 4 4
4 4 4 4 0 4 4 4 1 5 1 5 1 5 1 1 1 1 1 5 1 5 1 1 1 1 1 5 1 5 1 5 1 4 4 0 4 4 4 4 4
4 4 4 4 0 4 4 4 1 5 1 5 1 5 5 5 5 5 5 5 1 5 5 5 5 5 5 5 1 5 1 5 1 4 4 0 4 4 4 4 4
4 4 4 4 0 4 4 4 1 5 1 5 1 1 1 1 1 1 1 1 1 5 1 1 1 1 1 1 1 5 1 5 1 4 4 0 4 4 4 4 4
4 4 4 4 0 4 4 4 1 5 1 5 5 5 5 5 5 5 5 5 1 5 5 5 5 5 5 5 5 5 1 5 1 4 4 0 4 4 4 4 4
4 4 4 4 0 4 4 4 1 5 1 1 1 1 1 1 1 1 1 5 1 5 1 1 1 1 1 1 1 1 1 5 1 4 4 0 4 4 4 4 4
4 4 4 4 0 4 4 4 1 5 5 5 5 5 5 5 5 5 5 5 1 5 5 5 5 5 5 5 5 5 5 5 1 4 4 0 4 4 4 4 4
4 4 4 4 0 4 4 4 1 1 1 1 1 1 1 1 1 1 1 0 1 1 1 1 1 1 1 1 1 1 1 1 1 4 4 0 4 4 4 4 4
4 4 4 4 0 4 4 4 4 4 4 4 4 4 4 4 4 4 4 0 4 4 4 4 4 4 4 4 4 4 4 4 4 4 4 0 4 4 4 4 4
4 4 4 4 0 0 0 0 0 0 0 0 0 0 0 0 0 0 0 0 0 0 0 0 0 0 0 0 0 0 0 0 0 0 0 0 4 4 4 4 4
4 4 4 4 4 4 4 4 4 4 4 4 4 4 4 4 4 4 4 4 4 4 4 4 4 4 4 4 4 4 4 4 4 4 4 4 4 4 4 4 4
4 4 4 4 4 4 4 4 4 4 4 4 4 4 4 4 4 4 4 4 4 4 4 4 4 4 4 4 4 4 4 4 4 4 4 4 4 4 4 4 4 
4 4 4 4 4 4 4 4 4 4 4 4 4 4 4 4 4 4 4 4 4 4 4 4 4 4 4 4 4 4 4 4 4 4 4 4 4 4 4 4 4 
4 4 4 4 4 4 4 4 4 4 4 4 4 4 4 4 4 4 4 4 4 4 4 4 4 4 4 4 4 4 4 4 4 4 4 4 4 4 4 4 4 
4 4 4 4 4 4 4 4 4 4 4 4 4 4 4 4 4 4 4 4 4 4 4 4 4 4 4 4 4 4 4 4 4 4 4 4 4 4 4 4 4 