4 4 4 4 4 4 4 4 4 4 4 4 4 4 4 4 4 4 4 4 4 4 4 4 4 4 4 4 4 4 4 4 4 4 4 4 4 4 4 4 4
4 4 4 4 4 4 4 4 4 4 4 4 4 4 4 4 4 4 4 4 4 4 4 4 4 4 4 4 4 4 4 4 4 4 4 4 4 4 4 4 4 
4 4 4 4 4 4 4 4 4 4 4 4 4 4 4 4 4 4 4 4 4 4 4 4 4 4 4 4 4 4 4 4 4 4 4 4 4 4 4 4 4 
4 4 4 4 4 4 4 4 4 4 4 4 4 4 4 4 4 4 4 4 4 4 4 4 4 4 4 4 4 4 4 4 4 4 4 4 4 4 4 4 4 
4 4 4 4 4 4 4 4 4 4 4 4 4 4 4 4 4 4 4 4 4 4 4 4 4 4 4 4 4 4 4 4 4 4 4 4 4 4 4 4 4 
4 4 4 4 4 4 4 4 4 4 4 4 4 4 4 4 4 4 4 5 4 4 4 4 4 4 4 4 4 4 4 4 4 4 4 4 4 4 4 4 4 
4 4 4 4 4 4 4 4 4 4 4 4 4 4 4 4 4 4 4 4 4 4 4 4 4 4 4 4 4 4 4 4 4 4 4 4 4 4 4 4 4 
4 4 4 4 4 4 4 4 4 4 4 4 4 4 4 4 4 4 4 4 4 4 4 4 4 4 4 4 4 4 4 4 4 4 4 4 4 4 4 4 4 
4 4 4 4 4 4 4 4 4 5 5 5 5 5 5 5 5 5 4 5 4 5 5 5 5 5 5 5 5 5 5 5 4 4 4 4 4 4 4 4 4 
4 4 4 4 4 4 4 4 4 5 4 4 4 4 4 4 4 5 4 5 4 5 4 4 4 4 4 4 4 4 4 5 4 4 4 4 4 4 4 4 4 
4 4 4 4 4 4 4 4 4 5 4 5 5 5 5 5 5 5 4 5 4 5 5 5 5 5 5 5 5 5 4 5 4 4 4 4 4 4 4 4 4 
4 4 4 4 4 4 4 4 4 5 4 5 4 4 4 4 4 4 4 5 4 4 4 4 4 4 4 4 4 5 4 5 4 4 4 4 4 4 4 4 4 
4 4 4 4 4 4 4 4 4 5 4 5 4 5 5 5 5 5 4 5 4 5 5 5 5 5 5 5 4 5 4 5 4 4 4 4 4 4 4 4 4 
4 4 4 4 4 4 4 4 4 5 4 5 4 5 4 5 4 4 4 5 4 5 4 4 4 4 4 5 4 5 4 5 4 4 4 4 4 4 4 4 4 
4 4 4 4 4 4 4 4 4 5 4 5 4 5 4 5 4 5 5 5 4 5 5 5 5 5 4 5 4 5 4 5 4 4 4 4 4 4 4 4 4 
4 4 4 4 4 4 4 4 4 5 4 5 4 5 4 5 4 5 4 4 4 4 4 4 4 5 4 5 4 5 4 5 4 4 4 4 4 4 4 4 4 
4 4 4 4 4 4 4 4 4 5 4 5 4 5 4 5 4 5 4 0 0 0 5 5 4 5 4 5 4 5 4 5 4 4 4 4 4 4 4 4 4
4 4 4 4 4 4 4 4 4 5 4 5 5 5 4 5 5 5 4 2 0 2 4 5 5 5 4 5 5 5 4 5 4 4 4 4 4 4 4 4 4
4 4 4 4 4 4 4 4 4 5 4 4 4 4 4 4 4 4 4 2 2 2 4 4 4 4 4 4 4 4 4 5 4 4 4 4 4 4 4 4 4
4 4 4 4 4 4 4 4 4 5 4 5 5 5 4 5 5 5 4 4 4 4 4 5 5 5 4 5 5 5 4 5 4 4 4 4 4 4 4 4 4 
4 4 4 4 4 4 4 4 4 5 4 5 4 5 4 5 4 5 5 5 5 5 5 5 4 5 4 5 4 5 4 5 4 4 4 4 4 4 4 4 4 
4 4 4 4 4 4 4 4 4 5 4 5 4 5 4 5 4 4 4 4 4 4 4 4 4 5 4 5 4 5 4 5 4 4 4 4 4 4 4 4 4
4 4 4 4 4 4 4 4 4 5 4 5 4 5 4 5 5 5 5 5 4 5 5 5 5 5 4 5 4 5 4 5 4 4 4 4 4 4 4 4 4 
4 4 4 4 4 4 4 4 4 5 4 5 4 5 4 4 4 4 4 5 4 5 4 4 4 4 4 5 4 5 4 5 4 4 4 4 4 4 4 4 4 
4 4 4 4 4 4 4 4 4 5 4 5 4 5 5 5 5 5 5 5 4 5 5 5 5 5 5 5 4 5 4 5 4 4 4 4 4 4 4 4 4 
4 4 4 4 4 4 4 4 4 5 4 5 4 4 4 4 4 4 4 4 4 5 4 4 4 4 4 4 4 5 4 5 4 4 4 4 4 4 4 4 4 
4 4 4 4 4 4 4 4 4 5 4 5 5 5 5 5 5 5 5 5 4 5 5 5 5 5 5 5 5 5 4 5 4 4 4 4 4 4 4 4 4 
4 4 4 4 4 4 4 4 4 5 4 4 4 4 4 4 4 4 4 5 4 5 4 4 4 4 4 4 4 4 4 5 4 4 4 4 4 4 4 4 4 
4 4 4 4 4 4 4 4 4 5 5 5 5 5 5 5 5 5 5 5 4 5 5 5 5 5 5 5 5 5 5 5 4 4 4 4 4 4 4 4 4 
4 4 4 4 4 4 4 4 4 4 4 4 4 4 4 4 4 4 4 4 4 4 4 4 4 4 4 4 4 4 4 4 4 4 4 4 4 4 4 4 4 
4 4 4 4 4 4 4 4 4 4 4 4 4 4 4 4 4 4 4 4 4 4 4 4 4 4 4 4 4 4 4 4 4 4 4 4 4 4 4 4 4 
4 4 4 4 4 4 4 4 4 4 4 4 4 4 4 4 4 4 4 4 4 4 4 4 4 4 4 4 4 4 4 4 4 4 4 4 4 4 4 4 4 
4 4 4 4 4 4 4 4 4 4 4 4 4 4 4 4 4 4 4 4 4 4 4 4 4 4 4 4 4 4 4 4 4 4 4 4 4 4 4 4 4 
4 4 4 4 4 4 4 4 4 4 4 4 4 4 4 4 4 4 4 4 4 4 4 4 4 4 4 4 4 4 4 4 4 4 4 4 4 4 4 4 4 
4 4 4 4 4 4 4 4 4 4 4 4 4 4 4 4 4 4 4 4 4 4 4 4 4 4 4 4 4 4 4 4 4 4 4 4 4 4 4 4 4 
4 4 4 4 4 4 4 4 4 4 4 4 4 4 4 4 4 4 4 4 4 4 4 4 4 4 4 4 4 4 4 4 4 4 4 4 4 4 4 4 4 
4 4 4 4 4 4 4 4 4 4 4 4 4 4 4 4 4 4 4 4 4 4 4 4 4 4 4 4 4 4 4 4 4 4 4 4 4 4 4 4 4 